
EA        /Users/eismail/Desktop/cook3D
WE      /Users/eismail/Desktop/cook3D




NO /Users/eismail/Desktop/cook3D
SO /Users/eismail/Desktop/cook3D     
F                 12 , 1   ,     +1  
C 255, 12 ,0

1111111111     111
1000000001     101
1111000001     111
1000000001
1000001001
1010W00011
100000000111111111
111111100000000001
      100000111001
      100000001001
      100011111001
      100001100001
      100001000001
      111111111111