
EA        /Users/ysouhail/Desktop/hhh
WE      /Users/ysouhail/Desktop/hhh




NO /Users/ysouhail/Desktop/hhh 
SO /Users/ysouhail/Desktop/hhh     
F                 12 , 1   ,     +1  
C 255, 12 ,0

111111111111111111111111111
100000000000000000000000001
100000011011011011011011001
100000011011011011011011001
100000000000000000000000001
10000000000000000S000000001
100000000000000000000000001
100000011011011011011011001
100000011011011011011011001
100000000000000000000000001
111111111111111111111111111