
EA        /Users/ysouhail/Desktop/issa
WE      /Users/ysouhail/Desktop/issa




NO /Users/ysouhail/Desktop/issa
SO /Users/ysouhail/Desktop/issa     
F                 12 , 1   ,     +1  
C 255, 12 ,0

1111111111     
1000000001     111
1111000001     101
1000000001     111   
1000001001
101000S011
100000000111111111
111110100000000001
    10100000111001
    10100000001001
    10100011111001
    10100001100001
    10100000000001
    10111111001111
    10111110011111
    10111100111111
111110000000111111
111111111111111111