111111111111111111111111111
100000000000000000000000001
101111111011111111111111101
10000000000000000P000000001
101111111011111111111111101
100000000000000000000000001
101111111011111111111111101
100000000000000000000000001
111111111111111111111111111
