111111111111111111111111111
100000000000000000000000001
100000011011011011011011001
100000011011011011011011001
100000000000000000000000001
10000000000000000P000000001
100000000000000000000000001
100000011011011011011011001
100000011011011011011011001
100000000000000000000000001
111111111111111111111111111


11 1111111111111111            
11 11111111111 111            
11 11111111111 111         
11101111 11011 11111
111111 11100111011
1111111111011  1
111111111101
10000000011S1
111111111111