EA        /Users/eismail/Desktop/cook3D/text/i4.png
WE      /Users/eismail/Desktop/cook3D/text/i2.png




NO /Users/eismail/Desktop/cook3D/text/i3.png
SO /Users/eismail/Desktop/cook3D/text/i1.png     
C                 0,0,0
F 78,75,55



1111111111 
10E0000001     111
1111000001     101 
1000000001     111  
1000001001
1010000011
100000000111111111
1111101011111111111111111111111
111110100000000001
    10100000111001
    101000000001001
    10100011111001
    10100001100001
    10100000000001
    10111111001111
    10111110011111
    10111100111111
111110000000111111
111111111111111

