EA        /Users/eismail/Desktop/cook3D/text/i4.png
WE      /Users/eismail/Desktop/cook3D/text/i2.png




NO /Users/eismail/Desktop/cook3D/text/i3.png
SO /Users/eismail/Desktop/cook3D/text/i1.png     
C                 0,0,0
F 78,75,55

1111111111111111111111111111111111111111111111111111111111111111111111
1000000000000000000000000000000000000000000000000000000000000000000001
1000000000000000000000000000000000000000000000000000000000000000000001
1000000000000000000000000011111111111111111100000000000000000000000001
1000000000000000000001111111111000000011111111111000000000000000000001
1000000000000000000111111111100000000000000001111110000000000000000001
1000000000000000111110000111101111111111000000000111110000000000000001
1000000000000011110000000111111111111111111110000001111100000000000001
1000000000001111000000011111000000000000011111110000011110000000000001
1000000000001110000111100000000000000000111001110000001111100000000001
1000000000100000011111000001111111111111110000000111000001100000000001
1000000001110000111100000110000000000011111110000111100001100000000001
1000000011100001111111011110000000000000001111100001110000011100000001
1000000111000011101111111000011110001111100011110000111000011100000001
1000000111000111000000000001111110000111111000111000011100001110000001
1000001110000111000000000011110000000000111100011100011110001110000001
1000001110001111000110000111000000000000011110011110001110001111000001
1000001111111110000110001111000000110000001111111110001111111111000001
1000001111111111000110001111000001110000001111111110001111111111000001
1000001110001110000111001111000000000000001110011110001110001111000001
1000001110000111000111000111100000000000011100011100001110001111000001
1000001111000111000011100011111000000001111000111100011110001110000001
1000000111000011100001111111111111101111110000111100011110001110000001
1000000111100000000000111110000111101100000001110000111000011100000001
1000000011110000111000001111100000000000111110000011110000111000000001
1000000001111000011110000001111111111111111100000111100001111000000001
1000000000111100001111100000000001111111011100011110000111100000000001
1000000000011111000011111100000000000000001111111100001111000000000001
1000000000000111100000011111111000001011111111100000111100000000000001
1000000000000001111100000111111100011111111000000011111000000000000001
1000000000000000011111101110000100000000000010011111000000000000000001
1000000000000000000111111110000000000000001111111000000000000000000001
1000000000000000000000011111111111111000111111000000000000000000000001
1000000000000000000000000000001111111000000000000000000000000W00000001
1000000000000000000000000000000000111100000000000000000000000000001111
1000000000000000000000000000000000000000000000000000000000000000000001
1111111111111111111111111111111111111111111111111111111111111111111111




